1111111111111
1N010000000C1
1000011111001
1P0011E000001
111111111111
